12
╔══════════════════════════════════╗
║ ENTRANCE              EXIT       ║
║ ┌───┐                ┌───┐       ║
║ │ T │                │ P │       ║
║ └─┬─┘                └─┬─┘       ║
║   │                    │         ║
║   ▼                    ▼         ║
║ ─────────────────────────────── ║
║ | [ ] | [ ] | [ ] | [ ] | [ ] | ║
║ | [ ] | [ ] | [ ] | [ ] | [ ] | ║
║ | [ ] | [ ] |                  | ║
╚══════════════════════════════════╝
